{

  "layout": [
    ["W", "W", "W", "W", "W", "W", "W", "W", "W", "W", "W", "W", "W", "W", "W", "W", "W", "W", "W", "W", "W"],
    ["W", "F", "F", "F", "W", "W", "W", "F", "F", "F", "W", "F", "F", "F", "F", "F", "F", "F", "F", "F", "W"],
    ["W", "F", "F", "F", "F", "F", "W", "F", "F", "F", "W", "F", "F", "F", "F", "F", "F", "F", "F", "F", "W"],
    ["W", "F", "F", "F", "W", "F", "W", "F", "F", "F", "W", "F", "F", "F", "F", "F", "F", "F", "F", "F", "W"],
    ["W", "W", "F", "W", "W", "F", "W", "W", "F", "W", "W", "W", "F", "F", "F", "F", "F", "F", "F", "F", "W"],
    ["W", "F", "F", "F", "W", "F", "F", "F", "F", "F", "F", "W", "W", "W", "F", "F", "F", "F", "F", "F", "W"],
    ["W", "F", "F", "F", "W", "W", "W", "W", "W", "W", "F", "F", "F", "W", "F", "F", "F", "F", "F", "F", "W"],
    ["W", "F", "W", "F", "F", "F", "F", "F", "F", "W", "F", "F", "F", "W", "F", "F", "F", "F", "F", "F", "W"],
    ["W", "F", "F", "F", "W", "F", "F", "W", "F", "F", "F", "F", "F", "W", "F", "F", "F", "F", "F", "F", "W"],
    ["W", "F", "F", "F", "F", "F", "F", "F", "F", "W", "F", "W", "F", "W", "F", "F", "F", "F", "F", "F", "W"],
    ["W", "W", "W", "W", "W", "W", "W", "W", "W", "W", "F", "F", "F", "W", "F", "F", "F", "F", "F", "F", "W"],
    ["W", "F", "F", "F", "F", "F", "F", "F", "F", "W", "F", "F", "F", "W", "F", "F", "F", "F", "F", "F", "W"],
    ["W", "F", "F", "F", "F", "F", "F", "F", "F", "W", "F", "F", "F", "W", "F", "F", "F", "F", "F", "F", "W"],
    ["W", "F", "F", "F", "F", "F", "F", "F", "F", "W", "W", "W", "W", "W", "F", "F", "F", "F", "F", "F", "W"],
    ["W", "F", "F", "F", "F", "F", "F", "F", "F", "F", "F", "F", "F", "F", "F", "F", "F", "F", "F", "F", "W"],
    ["W", "F", "F", "F", "F", "F", "F", "F", "F", "F", "F", "F", "F", "F", "F", "F", "F", "F", "F", "F", "W"],
    ["W", "F", "F", "F", "F", "F", "F", "F", "F", "F", "F", "F", "F", "F", "F", "F", "F", "F", "F", "F", "W"],
    ["W", "F", "F", "F", "F", "F", "F", "F", "F", "F", "F", "F", "F", "F", "F", "F", "F", "F", "F", "F", "W"],
    ["W", "F", "F", "F", "F", "F", "F", "F", "F", "F", "F", "F", "F", "F", "F", "F", "F", "F", "F", "F", "W"],
    ["W", "F", "F", "F", "F", "F", "F", "F", "F", "F", "F", "F", "F", "F", "F", "F", "F", "F", "F", "F", "W"],
    ["W", "F", "F", "F", "F", "F", "F", "F", "F", "F", "F", "F", "F", "F", "F", "F", "F", "F", "F", "F", "W"],
    ["W", "F", "F", "F", "F", "F", "F", "F", "F", "F", "F", "F", "F", "F", "F", "F", "F", "F", "F", "F", "W"],
    ["W", "F", "F", "F", "F", "F", "F", "F", "F", "F", "F", "F", "F", "F", "F", "F", "F", "F", "F", "F", "W"],
    ["W", "F", "F", "F", "F", "F", "F", "F", "F", "F", "F", "F", "F", "F", "F", "F", "F", "F", "F", "F", "W"],
    ["W", "F", "F", "F", "F", "F", "F", "F", "F", "F", "F", "F", "F", "F", "F", "F", "F", "F", "F", "F", "W"],
    ["W", "F", "F", "F", "F", "F", "F", "F", "F", "F", "F", "F", "F", "F", "F", "F", "F", "F", "F", "F", "W"],
    ["W", "E", "E", "E", "E", "E", "E", "E", "E", "E", "E", "E", "E", "E", "E", "E", "E", "E", "E", "E", "W"],
    ["W", "E", "E", "E", "E", "E", "E", "E", "E", "E", "E", "E", "E", "E", "E", "E", "E", "E", "E", "E", "W"],
    ["W", "E", "E", "E", "E", "E", "E", "E", "E", "E", "E", "E", "E", "E", "E", "E", "E", "E", "E", "E", "W"],
    ["W", "W", "W", "W", "W", "W", "W", "W", "W", "W", "W", "W", "W", "W", "W", "W", "W", "W", "W", "W", "W"]
  ],
  "player": {
    "spawn": { "x": 2, "y": 2 },
    "camera": {
      "yaw": 180
    }
  }
}